date,state,positive,negative,tests,
20200412,AK,272,7766,8038,43
20200412,AL,3525,18058,21583,43
20200412,AR,1280,18442,19722,43
20200412,AS,0,3,3,43
20200412,AZ,3539,38570,42109,43
20200412,CA,21794,168534,190328,43
20200412,CO,6893,27980,34873,43
20200412,CT,12035,29185,41220,43
20200412,DC,1875,8765,10640,43
20200412,DE,1479,9624,11103,43
20200412,FL,19355,163398,182753,43
20200412,GA,12452,42001,54453,43
20200412,GU,133,693,826,43
20200412,HI,486,17482,17968,43
20200412,IA,1587,16005,17592,43
20200412,ID,1407,12901,14308,43
20200412,IL,20852,79883,100735,43
20200412,IN,7928,34561,42489,43
20200412,KS,1337,11916,13253,43
20200412,KY,1840,22727,24567,43
20200412,LA,20595,83450,104045,43
20200412,MA,25381,91463,116844,43
20200412,MD,8225,41539,49764,43
20200412,ME,633,6088,6721,43
20200412,MI,24638,54799,79437,43
20200412,MN,1621,35800,37421,43
20200412,MO,4160,41040,45200,43
20200412,MP,11,27,38,43
20200412,MS,2781,18632,21413,43
20200412,MT,387,8526,8913,43
20200412,NC,4520,57619,62139,43
20200412,ND,308,10042,10350,43
20200412,NE,791,9900,10691,43
20200412,NH,929,9996,10925,43
20200412,NJ,61850,64885,126735,43
20200412,NM,1174,27518,28692,43
20200412,NV,2836,21775,24611,43
20200412,NY,188694,272907,461601,43
20200412,OH,6604,56639,63243,43
20200412,OK,1970,20790,22760,43
20200412,OR,1527,28231,29758,43
20200412,PA,22833,102057,124890,43
20200412,PR,897,5819,6716,43
20200412,RI,2665,17685,20350,43
20200412,SC,3319,28106,31425,43
20200412,SD,730,7823,8553,43
20200412,TN,5308,65369,70677,43
20200412,TX,13484,111049,124533,43
20200412,UT,2303,41931,44234,43
20200412,VA,5274,34711,39985,43
20200412,VI,51,299,350,43
20200412,VT,727,9114,9841,43
20200412,WA,10398,119533,129931,43
20200412,WI,3341,35916,39257,43
20200412,WV,611,15646,16257,43
20200412,WY,261,5198,5459,43
20200411,AK,257,7475,7732,42
20200411,AL,3191,18058,21249,42
20200411,AR,1226,17352,18578,42
20200411,AS,0,3,3,42
20200411,AZ,3393,37137,40530,42
20200411,CA,19472,152604,172076,42
20200411,CO,6510,26143,32653,42
20200411,CT,11510,28321,39831,42
20200411,DC,1778,8261,10039,42
20200411,DE,1479,9624,11103,42
20200411,FL,18494,154439,172933,42
20200411,GA,12159,39556,51715,42
20200411,GU,133,693,826,42
20200411,HI,465,17066,17531,42
20200411,IA,1510,15622,17132,42
20200411,ID,1396,12368,13764,42
20200411,IL,19180,72969,92149,42
20200411,IN,7435,31780,39215,42
20200411,KS,1268,11075,12343,42
20200411,KY,1693,22595,24288,42
20200411,LA,20014,76901,96915,42
20200411,MA,22766,86115,108881,42
20200411,MD,7694,39544,47238,42
20200411,ME,616,6088,6704,42
20200411,MI,23993,52021,76014,42
20200411,MN,1427,33977,35404,42
20200411,MO,4024,39148,43172,42
20200411,MP,11,27,38,42
20200411,MS,2642,18632,21274,42
20200411,MT,377,8204,8581,42
20200411,NC,4312,56081,60393,42
20200411,ND,293,9787,10080,42
20200411,NE,700,9285,9985,42
20200411,NH,885,9608,10493,42
20200411,NJ,58151,62042,120193,42
20200411,NM,1091,26007,27098,42
20200411,NV,2700,20887,23587,42
20200411,NY,180458,260522,440980,42
20200411,OH,6250,54221,60471,42
20200411,OK,1868,20790,22658,42
20200411,OR,1371,25853,27224,42
20200411,PA,21655,98498,120153,42
20200411,PR,788,5583,6371,42
20200411,RI,2349,15858,18207,42
20200411,SC,3207,26886,30093,42
20200411,SD,626,7378,8004,42
20200411,TN,5114,61714,66828,42
20200411,TX,12561,107972,120533,42
20200411,UT,2206,40340,42546,42
20200411,VA,5077,32922,37999,42
20200411,VI,51,299,350,42
20200411,VT,711,8547,9258,42
20200411,WA,10162,118236,128398,42
20200411,WI,3213,34680,37893,42
20200411,WV,577,14875,15452,42
20200411,WY,261,5198,5459,42
20200410,AK,246,7186,7432,41
20200410,AL,2968,18058,21026,41
20200410,AR,1171,15949,17120,41
20200410,AS,0,3,3,41
20200410,AZ,3112,34622,37734,41
20200410,CA,19472,145391,164863,41
20200410,CO,6510,26143,32653,41
20200410,CT,10538,25750,36288,41
20200410,DC,1660,7695,9355,41
20200410,DE,1326,10415,11741,41
20200410,FL,17531,145299,162830,41
20200410,GA,11483,34664,46147,41
20200410,GU,130,662,792,41
20200410,HI,442,15707,16149,41
20200410,IA,1388,14565,15953,41
20200410,ID,1353,11741,13094,41
20200410,IL,17887,69640,87527,41
20200410,IN,6907,28133,35040,41
20200410,KS,1166,10248,11414,41
20200410,KY,1693,22595,24288,41
20200410,LA,19253,73027,92280,41
20200410,MA,20878,81564,102442,41
20200410,MD,6968,37480,44448,41
20200410,ME,586,6088,6674,41
20200410,MI,22783,49261,72044,41
20200410,MN,1336,32558,33894,41
20200410,MO,3799,36941,40740,41
20200410,MP,11,27,38,41
20200410,MS,2469,18632,21101,41
20200410,MT,365,7932,8297,41
20200410,NC,3908,53737,57645,41
20200410,ND,278,9330,9608,41
20200410,NE,635,8719,9354,41
20200410,NH,819,9139,9958,41
20200410,NJ,54588,58935,113523,41
20200410,NM,1091,26007,27098,41
20200410,NV,2584,20165,22749,41
20200410,NY,170512,247373,417885,41
20200410,OH,5878,52695,58573,41
20200410,OK,1794,20370,22164,41
20200410,OR,1321,24306,25627,41
20200410,PA,19979,93040,113019,41
20200410,PR,725,5121,5846,41
20200410,RI,2015,12281,14296,41
20200410,SC,3065,25118,28183,41
20200410,SD,536,7111,7647,41
20200410,TN,4862,57937,62799,41
20200410,TX,11671,104047,115718,41
20200410,UT,2102,38660,40762,41
20200410,VA,4509,30950,35459,41
20200410,VI,50,273,323,41
20200410,VT,679,7553,8232,41
20200410,WA,9941,116396,126337,41
20200410,WI,3068,33225,36293,41
20200410,WV,554,14001,14555,41
20200410,WY,253,4736,4989,41
20200409,AK,235,6988,7223,40
20200409,AL,2769,18058,20827,40
20200409,AR,1119,13832,14951,40
20200409,AS,0,3,3,40
20200409,AZ,3018,34160,37178,40
20200409,CA,18309,145191,163500,40
20200409,CO,5655,23544,29199,40
20200409,CT,9784,23718,33502,40
20200409,DC,1523,7201,8724,40
20200409,DE,1207,8683,9890,40
20200409,FL,16364,136185,152549,40
20200409,GA,10566,30519,41085,40
20200409,GU,128,593,721,40
20200409,HI,435,15316,15751,40
20200409,IA,1270,13703,14973,40
20200409,ID,1232,11299,12531,40
20200409,IL,16422,64435,80857,40
20200409,IN,6351,25782,32133,40
20200409,KS,1106,9669,10775,40
20200409,KY,1346,20455,21801,40
20200409,LA,18283,68636,86919,40
20200409,MA,18843,76146,94989,40
20200409,MD,6185,35344,41529,40
20200409,ME,560,6088,6648,40
20200409,MI,21504,45550,67054,40
20200409,MN,1242,31052,32294,40
20200409,MO,3539,34955,38494,40
20200409,MP,11,27,38,40
20200409,MS,2260,18632,20892,40
20200409,MT,354,7506,7860,40
20200409,NC,3651,44158,47809,40
20200409,ND,269,8721,8990,40
20200409,NE,567,8116,8683,40
20200409,NH,788,8763,9551,40
20200409,NJ,51027,56165,107192,40
20200409,NM,865,22942,23807,40
20200409,NV,2456,19315,21771,40
20200409,NY,159937,231612,391549,40
20200409,OH,5512,50473,55985,40
20200409,OK,1684,18595,20279,40
20200409,OR,1321,24306,25627,40
20200409,PA,18228,87374,105602,40
20200409,PR,683,4703,5386,40
20200409,RI,1727,10682,12409,40
20200409,SC,2792,24575,27367,40
20200409,SD,447,6700,7147,40
20200409,TN,4634,55215,59849,40
20200409,TX,10230,95904,106134,40
20200409,UT,1976,36397,38373,40
20200409,VA,4042,28984,33026,40
20200409,VI,46,251,297,40
20200409,VT,628,7553,8181,40
20200409,WA,9492,112544,122036,40
20200409,WI,2885,31424,34309,40
20200409,WV,523,13340,13863,40
20200409,WY,230,3920,4150,40
20200408,AK,226,6842,7068,39
20200408,AL,2369,16753,19122,39
20200408,AR,1000,13530,14530,39
20200408,AS,0,3,3,39
20200408,AZ,2726,31838,34564,39
20200408,CA,16957,127307,144264,39
20200408,CO,5429,22665,28094,39
20200408,CT,7781,21255,29036,39
20200408,DC,1440,6843,8283,39
20200408,DE,928,7628,8556,39
20200408,FL,15455,127679,143134,39
20200408,GA,9901,28886,38787,39
20200408,GU,125,562,687,39
20200408,HI,410,14739,15149,39
20200408,IA,1145,12821,13966,39
20200408,ID,1210,10688,11898,39
20200408,IL,15078,59988,75066,39
20200408,IN,5943,24926,30869,39
20200408,KS,1046,9137,10183,39
20200408,KY,1149,20455,21604,39
20200408,LA,17030,64376,81406,39
20200408,MA,16692,70849,87541,39
20200408,MD,5529,32933,38462,39
20200408,ME,537,6088,6625,39
20200408,MI,20589,45550,66139,39
20200408,MN,1154,29599,30753,39
20200408,MO,3327,30783,34110,39
20200408,MP,11,27,38,39
20200408,MS,2003,18632,20635,39
20200408,MT,332,7066,7398,39
20200408,NC,3426,39561,42987,39
20200408,ND,251,8301,8552,39
20200408,NE,519,7442,7961,39
20200408,NH,788,8389,9177,39
20200408,NJ,47437,52979,100416,39
20200408,NM,794,21451,22245,39
20200408,NV,2318,18248,20566,39
20200408,NY,149316,215837,365153,39
20200408,OH,5148,48193,53341,39
20200408,OK,1524,11821,13345,39
20200408,OR,1239,23325,24564,39
20200408,PA,16239,82299,98538,39
20200408,PR,620,4266,4886,39
20200408,RI,1450,10682,12132,39
20200408,SC,2552,22082,24634,39
20200408,SD,393,6355,6748,39
20200408,TN,4362,52256,56618,39
20200408,TX,9353,86905,96258,39
20200408,UT,1846,34270,36116,39
20200408,VA,3645,27000,30645,39
20200408,VI,45,242,287,39
20200408,VT,605,7144,7749,39
20200408,WA,9214,108847,118061,39
20200408,WI,2756,30115,32871,39
20200408,WV,462,12083,12545,39
20200408,WY,221,3843,4064,39
20200407,AK,213,6700,6913,38
20200407,AL,2119,12797,14916,38
20200407,AR,946,12692,13638,38
20200407,AS,0,3,3,38
20200407,AZ,2575,30800,33375,38
20200407,CA,15865,115364,131229,38
20200407,CO,5172,21703,26875,38
20200407,CT,7781,21255,29036,38
20200407,DC,1211,6612,7823,38
20200407,DE,928,7628,8556,38
20200407,FL,14747,123415,138162,38
20200407,GA,8818,24895,33713,38
20200407,GU,121,529,650,38
20200407,HI,387,13155,13542,38
20200407,IA,1048,11670,12718,38
20200407,ID,1170,10076,11246,38
20200407,IL,13549,55183,68732,38
20200407,IN,5507,23257,28764,38
20200407,KS,900,8614,9514,38
20200407,KY,1008,18947,19955,38
20200407,LA,16284,58371,74655,38
20200407,MA,15104,66270,81374,38
20200407,MD,4371,27256,31627,38
20200407,ME,519,6088,6607,38
20200407,MI,19823,45550,65373,38
20200407,MN,1069,28191,29260,38
20200407,MO,3037,28932,31969,38
20200407,MP,8,15,23,38
20200407,MS,1915,18632,20547,38
20200407,MT,319,6666,6985,38
20200407,NC,3221,37861,41082,38
20200407,ND,237,7466,7703,38
20200407,NE,447,6811,7258,38
20200407,NH,715,8019,8734,38
20200407,NJ,44416,50558,94974,38
20200407,NM,686,21139,21825,38
20200407,NV,2087,16552,18639,38
20200407,NY,138863,201195,340058,38
20200407,OH,4782,46056,50838,38
20200407,OK,1472,11821,13293,38
20200407,OR,1181,21826,23007,38
20200407,PA,14559,76719,91278,38
20200407,PR,573,3966,4539,38
20200407,RI,1230,9077,10307,38
20200407,SC,2417,21263,23680,38
20200407,SD,320,5948,6268,38
20200407,TN,4138,48736,52874,38
20200407,TX,8262,80387,88649,38
20200407,UT,1738,32909,34647,38
20200407,VA,3333,25312,28645,38
20200407,VI,43,222,265,38
20200407,VT,575,6554,7129,38
20200407,WA,8859,104511,113370,38
20200407,WI,2578,28512,31090,38
20200407,WV,412,11647,12059,38
20200407,WY,216,3789,4005,38
20200406,AK,191,6692,6883,37
20200406,AL,1968,12797,14765,37
20200406,AR,875,11970,12845,37
20200406,AS,0,3,3,37
20200406,AZ,2456,30078,32534,37
20200406,CA,14336,103095,117431,37
20200406,CO,4950,20823,25773,37
20200406,CT,6906,19780,26686,37
20200406,DC,1097,6356,7453,37
20200406,DE,673,6321,6994,37
20200406,FL,13324,109950,123274,37
20200406,GA,7314,23960,31274,37
20200406,GU,113,505,618,37
20200406,HI,371,13155,13526,37
20200406,IA,946,10653,11599,37
20200406,ID,1101,9894,10995,37
20200406,IL,12262,50680,62942,37
20200406,IN,4944,21247,26191,37
20200406,KS,845,8239,9084,37
20200406,KY,955,17812,18767,37
20200406,LA,14867,54299,69166,37
20200406,MA,13739,62720,76459,37
20200406,MD,4045,25572,29617,37
20200406,ME,499,6088,6587,37
20200406,MI,18850,43120,61970,37
20200406,MN,986,27142,28128,37
20200406,MO,2722,27113,29835,37
20200406,MP,8,13,21,37
20200406,MS,1738,18632,20370,37
20200406,MT,299,6491,6790,37
20200406,NC,2870,37856,40726,37
20200406,ND,225,6988,7213,37
20200406,NE,409,6378,6787,37
20200406,NH,669,7701,8370,37
20200406,NJ,41090,47942,89032,37
20200406,NM,624,18512,19136,37
20200406,NV,1953,15676,17629,37
20200406,NY,130689,190122,320811,37
20200406,OH,4450,43928,48378,37
20200406,OK,1327,1422,2749,37
20200406,OR,1132,20669,21801,37
20200406,PA,12980,70874,83854,37
20200406,PR,513,3432,3945,37
20200406,RI,1082,7399,8481,37
20200406,SC,2049,16927,18976,37
20200406,SD,288,5732,6020,37
20200406,TN,3802,43548,47350,37
20200406,TX,7276,78081,85357,37
20200406,UT,1675,31719,33394,37
20200406,VA,2878,21643,24521,37
20200406,VI,43,222,265,37
20200406,VT,543,6090,6633,37
20200406,WA,8523,99837,108360,37
20200406,WI,2440,26574,29014,37
20200406,WV,345,9595,9940,37
20200406,WY,210,3719,3929,37
20200405,AK,185,6099,6284,36
20200405,AL,1796,11282,13078,36
20200405,AR,830,10412,11242,36
20200405,AS,0,3,3,36
20200405,AZ,2269,25141,27410,36
20200405,CA,13438,103095,116533,36
20200405,CO,4565,19335,23900,36
20200405,CT,5675,17595,23270,36
20200405,DC,998,5836,6834,36
20200405,DE,673,6321,6994,36
20200405,FL,12151,101253,113404,36
20200405,GA,6647,21185,27832,36
20200405,GU,112,493,605,36
20200405,HI,351,12604,12955,36
20200405,IA,868,9973,10841,36
20200405,ID,1077,9184,10261,36
20200405,IL,11256,47727,58983,36
20200405,IN,4411,18241,22652,36
20200405,KS,747,7476,8223,36
20200405,KY,917,15746,16663,36
20200405,LA,13010,47315,60325,36
20200405,MA,12402,59565,71967,36
20200405,MD,3609,24728,28337,36
20200405,ME,470,6088,6558,36
20200405,MI,17567,40331,57898,36
20200405,MN,935,25842,26777,36
20200405,MO,2367,24882,27249,36
20200405,MP,8,13,21,36
20200405,MS,1638,5580,7218,36
20200405,MT,286,6317,6603,36
20200405,NC,2585,37460,40045,36
20200405,ND,207,6580,6787,36
20200405,NE,363,5558,5921,36
20200405,NH,621,7411,8032,36
20200405,NJ,37505,44661,82166,36
20200405,NM,543,16285,16828,36
20200405,NV,1836,14995,16831,36
20200405,NY,122031,180249,302280,36
20200405,OH,4043,39713,43756,36
20200405,OK,1252,1401,2653,36
20200405,OR,1068,19556,20624,36
20200405,PA,11510,66261,77771,36
20200405,PR,475,3073,3548,36
20200405,RI,922,6259,7181,36
20200405,SC,2049,16927,18976,36
20200405,SD,240,5353,5593,36
20200405,TN,3633,41667,45300,36
20200405,TX,6812,64126,70938,36
20200405,UT,1605,29287,30892,36
20200405,VA,2637,21034,23671,36
20200405,VI,42,206,248,36
20200405,VT,512,6070,6582,36
20200405,WA,8181,95286,103467,36
20200405,WI,2267,25169,27436,36
20200405,WV,324,8514,8838,36
20200405,WY,197,3040,3237,36
20200404,AK,171,5869,6040,35
20200404,AL,1580,9273,10853,35
20200404,AR,743,9627,10370,35
20200404,AS,0,3,3,35
20200404,AZ,2019,25141,27160,35
20200404,CA,12026,101674,113700,35
20200404,CO,4173,17898,22071,35
20200404,CT,5276,16753,22029,35
20200404,DC,902,5536,6438,35
20200404,DE,593,5874,6467,35
20200404,FL,11111,90956,102067,35
20200404,GA,6160,20134,26294,35
20200404,GU,93,472,565,35
20200404,HI,319,11959,12278,35
20200404,IA,786,9454,10240,35
20200404,ID,1013,7857,8870,35
20200404,IL,10357,43224,53581,35
20200404,IN,3953,15847,19800,35
20200404,KS,698,6880,7578,35
20200404,KY,831,14741,15572,35
20200404,LA,12496,46002,58498,35
20200404,MA,11637,57191,68828,35
20200404,MD,3125,22485,25610,35
20200404,ME,456,6088,6544,35
20200404,MI,16395,37405,53800,35
20200404,MN,865,24558,25423,35
20200404,MO,2291,22614,24905,35
20200404,MP,8,13,21,35
20200404,MS,1455,5133,6588,35
20200404,MT,265,5912,6177,35
20200404,NC,2402,36371,38773,35
20200404,ND,186,6021,6207,35
20200404,NE,321,5058,5379,35
20200404,NH,540,6965,7505,35
20200404,NJ,34124,41232,75356,35
20200404,NM,495,15137,15632,35
20200404,NV,1742,14421,16163,35
20200404,NY,113704,169917,283621,35
20200404,OH,3739,38132,41871,35
20200404,OK,1159,1362,2521,35
20200404,OR,999,16535,17534,35
20200404,PA,10017,60013,70030,35
20200404,PR,452,2605,3057,35
20200404,RI,806,5584,6390,35
20200404,SC,1917,16397,18314,35
20200404,SD,212,5012,5224,35
20200404,TN,3321,38070,41391,35
20200404,TX,6110,57641,63751,35
20200404,UT,1428,26615,28043,35
20200404,VA,2407,19145,21552,35
20200404,VI,40,184,224,35
20200404,VT,461,5383,5844,35
20200404,WA,7792,93529,101321,35
20200404,WI,2112,23859,25971,35
20200404,WV,282,7404,7686,35
20200404,WY,187,2945,3132,35
20200403,AK,157,5859,6016,34
20200403,AL,1432,8187,9619,34
20200403,AR,704,8995,9699,34
20200403,AS,0,3,3,34
20200403,AZ,1769,22904,24673,34
20200403,CA,10701,24599,35300,34
20200403,CO,3728,16683,20411,34
20200403,CT,4914,15101,20015,34
20200403,DC,757,4827,5584,34
20200403,DE,450,4995,5445,34
20200403,FL,9585,82137,91722,34
20200403,GA,5831,19434,25265,34
20200403,GU,84,459,543,34
20200403,HI,285,10206,10491,34
20200403,IA,699,8754,9453,34
20200403,ID,891,7054,7945,34
20200403,IL,8904,39144,48048,34
20200403,IN,3437,14398,17835,34
20200403,KS,620,6454,7074,34
20200403,KY,770,12034,12804,34
20200403,LA,10297,43348,53645,34
20200403,MA,10303,52685,62988,34
20200403,MD,2758,20932,23690,34
20200403,ME,432,6088,6520,34
20200403,MI,15252,33670,48922,34
20200403,MN,789,23438,24227,34
20200403,MO,2113,19357,21470,34
20200403,MP,8,13,21,34
20200403,MS,1358,4753,6111,34
20200403,MT,243,5333,5576,34
20200403,NC,2093,29505,31598,34
20200403,ND,173,5625,5798,34
20200403,NE,279,4487,4766,34
20200403,NH,479,6575,7054,34
20200403,NJ,29895,37608,67503,34
20200403,NM,403,14375,14778,34
20200403,NV,1514,13018,14532,34
20200403,NY,102863,157657,260520,34
20200403,OH,3312,35063,38375,34
20200403,OK,988,1315,2303,34
20200403,OR,899,16535,17434,34
20200403,PA,8420,53695,62115,34
20200403,PR,378,2049,2427,34
20200403,RI,709,4857,5566,34
20200403,SC,1554,5441,6995,34
20200403,SD,187,4593,4780,34
20200403,TN,3067,34772,37839,34
20200403,TX,5330,50434,55764,34
20200403,UT,1246,23002,24248,34
20200403,VA,2012,16993,19005,34
20200403,VI,38,154,192,34
20200403,VT,389,4839,5228,34
20200403,WA,7424,91184,98608,34
20200403,WI,1912,22377,24289,34
20200403,WV,237,6130,6367,34
20200403,WY,162,2704,2866,34
20200402,AK,143,4879,5022,33
20200402,AL,1233,7503,8736,33
20200402,AR,643,7880,8523,33
20200402,AS,0,3,3,33
20200402,AZ,1598,21111,22709,33
20200402,CA,9191,23809,33000,33
20200402,CO,3342,15303,18645,33
20200402,CT,3824,14476,18300,33
20200402,DC,653,4417,5070,33
20200402,DE,393,4566,4959,33
20200402,FL,8010,69286,77296,33
20200402,GA,5348,17609,22957,33
20200402,GU,82,442,524,33
20200402,HI,258,10206,10464,33
20200402,IA,614,8054,8668,33
20200402,ID,669,6613,7282,33
20200402,IL,7695,35961,43656,33
20200402,IN,3039,13246,16285,33
20200402,KS,552,6059,6611,33
20200402,KY,680,7220,7900,33
20200402,LA,9150,41936,51086,33
20200402,MA,8867,47767,56634,33
20200402,MD,2331,18890,21221,33
20200402,ME,376,6088,6464,33
20200402,MI,14117,30368,44485,33
20200402,MN,742,21652,22394,33
20200402,MO,1834,17849,19683,33
20200402,MP,8,13,21,33
20200402,MS,1177,4753,5930,33
20200402,MT,227,5093,5320,33
20200402,NC,1857,26822,28679,33
20200402,ND,159,4821,4980,33
20200402,NE,246,3978,4224,33
20200402,NH,415,6078,6493,33
20200402,NJ,25590,33520,59110,33
20200402,NM,363,13648,14011,33
20200402,NV,1458,12588,14046,33
20200402,NY,92381,146584,238965,33
20200402,OH,2902,32016,34918,33
20200402,OK,879,1265,2144,33
20200402,OR,826,15259,16085,33
20200402,PA,7016,47698,54714,33
20200402,PR,316,1604,1920,33
20200402,RI,657,4412,5069,33
20200402,SC,1554,5441,6995,33
20200402,SD,165,4217,4382,33
20200402,TN,2845,31766,34611,33
20200402,TX,4669,46010,50679,33
20200402,UT,1074,20155,21229,33
20200402,VA,1706,15883,17589,33
20200402,VI,33,149,182,33
20200402,VT,338,4711,5049,33
20200402,WA,6893,86889,93782,33
20200402,WI,1730,20317,22047,33
20200402,WV,217,5276,5493,33
20200402,WY,150,2439,2589,33
20200401,AK,133,4470,4603,32
20200401,AL,1077,6697,7774,32
20200401,AR,584,7354,7938,32
20200401,AS,0,3,3,32
20200401,AZ,1413,19645,21058,32
20200401,CA,8155,21772,29927,32
20200401,CO,2966,13883,16849,32
20200401,CT,3557,13043,16600,32
20200401,DC,586,3262,3848,32
20200401,DE,368,4015,4383,32
20200401,FL,6955,59529,66484,32
20200401,GA,4638,15688,20326,32
20200401,GU,77,406,483,32
20200401,HI,208,8721,8929,32
20200401,IA,549,7304,7853,32
20200401,ID,525,6076,6601,32
20200401,IL,6980,33404,40384,32
20200401,IN,2565,11810,14375,32
20200401,KS,482,5411,5893,32
20200401,KY,591,6965,7556,32
20200401,LA,6424,39352,45776,32
20200401,MA,7639,44125,51764,32
20200401,MD,1985,17233,19218,32
20200401,ME,344,6088,6432,32
20200401,MI,12888,27237,40125,32
20200401,MN,689,20502,21191,32
20200401,MO,1581,15846,17427,32
20200401,MP,6,,6,32
20200401,MS,1073,3712,4785,32
20200401,MT,208,4710,4918,32
20200401,NC,1584,24659,26243,32
20200401,ND,142,4351,4493,32
20200401,NE,210,3475,3685,32
20200401,NH,415,5985,6400,32
20200401,NJ,22255,30387,52642,32
20200401,NM,315,12925,13240,32
20200401,NV,1279,11519,12798,32
20200401,NY,83712,137168,220880,32
20200401,OH,2547,26992,29539,32
20200401,OK,719,1248,1967,32
20200401,OR,736,13136,13872,32
20200401,PA,5805,42427,48232,32
20200401,PR,286,1409,1695,32
20200401,RI,566,3831,4397,32
20200401,SC,1293,5033,6326,32
20200401,SD,129,3903,4032,32
20200401,TN,2683,29769,32452,32
20200401,TX,3997,43860,47857,32
20200401,UT,1012,20155,21167,32
20200401,VA,1484,13860,15344,32
20200401,VI,30,126,156,32
20200401,VT,321,4174,4495,32
20200401,WA,6540,82557,89097,32
20200401,WI,1550,18819,20369,32
20200401,WV,191,4384,4575,32
20200401,WY,130,2218,2348,32
20200331,AK,119,3594,3713,31
20200331,AL,981,6298,7279,31
20200331,AR,523,5959,6482,31
20200331,AS,0,3,3,31
20200331,AZ,1289,18082,19371,31
20200331,CA,7482,21772,29254,31
20200331,CO,2627,12737,15364,31
20200331,CT,3128,13029,16157,31
20200331,DC,495,3262,3757,31
20200331,DE,319,3696,4015,31
20200331,FL,6338,54285,60623,31
20200331,GA,3929,12252,16181,31
20200331,GU,69,371,440,31
20200331,HI,204,8471,8675,31
20200331,IA,497,6888,7385,31
20200331,ID,415,5297,5712,31
20200331,IL,5994,29231,35225,31
20200331,IN,2159,11214,13373,31
20200331,KS,428,4996,5424,31
20200331,KY,480,6330,6810,31
20200331,LA,5237,33730,38967,31
20200331,MA,6521,40440,46961,31
20200331,MD,1660,14868,16528,31
20200331,ME,303,6088,6391,31
20200331,MI,11875,23979,35854,31
20200331,MN,629,19151,19780,31
20200331,MO,1327,14614,15941,31
20200331,MP,2,,2,31
20200331,MS,937,3537,4474,31
20200331,MT,184,4234,4418,31
20200331,NC,1498,21608,23106,31
20200331,ND,126,4131,4257,31
20200331,NE,172,2931,3103,31
20200331,NH,314,5413,5727,31
20200331,NJ,18696,27077,45773,31
20200331,NM,281,12246,12527,31
20200331,NV,1113,10681,11794,31
20200331,NY,75795,129391,205186,31
20200331,OH,2199,26992,29191,31
20200331,OK,565,1229,1794,31
20200331,OR,690,13136,13826,31
20200331,PA,4843,37645,42488,31
20200331,PR,239,1195,1434,31
20200331,RI,489,3476,3965,31
20200331,SC,1083,4616,5699,31
20200331,SD,108,3609,3717,31
20200331,TN,2239,25121,27360,31
20200331,TX,3266,39726,42992,31
20200331,UT,887,17626,18513,31
20200331,VA,1250,12151,13401,31
20200331,VI,30,126,156,31
20200331,VT,293,3957,4250,31
20200331,WA,6049,78384,84433,31
20200331,WI,1351,17375,18726,31
20200331,WV,162,3981,4143,31
20200331,WY,109,1999,2108,31
20200330,AK,114,3540,3654,30
20200330,AL,859,5694,6553,30
20200330,AR,473,5262,5735,30
20200330,AS,,,0,30
20200330,AZ,1157,15602,16759,30
20200330,CA,6447,20549,26996,30
20200330,CO,2627,12737,15364,30
20200330,CT,2571,12029,14600,30
20200330,DC,401,2682,3083,30
20200330,DE,264,2216,2480,30
20200330,FL,5473,48225,53698,30
20200330,GA,2809,9915,12724,30
20200330,GU,58,352,410,30
20200330,HI,175,7825,8000,30
20200330,IA,424,6162,6586,30
20200330,ID,310,4396,4706,30
20200330,IL,5057,25389,30446,30
20200330,IN,1786,9872,11658,30
20200330,KS,368,4554,4922,30
20200330,KY,439,5579,6018,30
20200330,LA,4025,30008,34033,30
20200330,MA,5653,37166,42819,30
20200330,MD,1413,13316,14729,30
20200330,ME,275,3394,3669,30
20200330,MI,10901,21183,32084,30
20200330,MN,576,18246,18822,30
20200330,MO,1031,13204,14235,30
20200330,MP,2,,2,30
20200330,MS,847,2989,3836,30
20200330,MT,171,4143,4314,30
20200330,NC,1307,19557,20864,30
20200330,ND,109,3728,3837,30
20200330,NE,145,2584,2729,30
20200330,NH,314,5386,5700,30
20200330,NJ,16636,25224,41860,30
20200330,NM,237,10942,11179,30
20200330,NV,1008,10207,11215,30
20200330,NY,66497,119971,186468,30
20200330,OH,1933,25342,27275,30
20200330,OK,481,1207,1688,30
20200330,OR,606,12277,12883,30
20200330,PA,4087,33777,37864,30
20200330,PR,174,931,1105,30
20200330,RI,402,3187,3589,30
20200330,SC,925,4160,5085,30
20200330,SD,101,3478,3579,30
20200330,TN,1834,21470,23304,30
20200330,TX,2877,33003,35880,30
20200330,UT,806,15197,16003,30
20200330,VA,1020,11018,12038,30
20200330,VI,30,126,156,30
20200330,VT,256,3674,3930,30
20200330,WA,5589,74258,79847,30
20200330,WI,1221,15856,17077,30
20200330,WV,126,2984,3110,30
20200330,WY,94,1840,1934,30
20200329,AK,102,3232,3334,29
20200329,AL,806,4184,4990,29
20200329,AR,426,3027,3453,29
20200329,AS,,,0,29
20200329,AZ,919,12953,13872,29
20200329,CA,5708,20549,26257,29
20200329,CO,2061,11215,13276,29
20200329,CT,1993,9907,11900,29
20200329,DC,342,2469,2811,29
20200329,DE,232,36,268,29
20200329,FL,4246,39070,43316,29
20200329,GA,2651,9913,12564,29
20200329,GU,56,334,390,29
20200329,HI,151,6849,7000,29
20200329,IA,336,5013,5349,29
20200329,ID,261,4021,4282,29
20200329,IL,4596,23166,27762,29
20200329,IN,1514,8316,9830,29
20200329,KS,319,4194,4513,29
20200329,KY,394,5147,5541,29
20200329,LA,3540,24331,27871,29
20200329,MA,4856,34234,39090,29
20200329,MD,1239,12354,13593,29
20200329,ME,253,3394,3647,29
20200329,MI,10010,15676,25686,29
20200329,MN,503,17154,17657,29
20200329,MO,838,11547,12385,29
20200329,MP,2,,2,29
20200329,MS,758,2560,3318,29
20200329,MT,154,4143,4297,29
20200329,NC,1040,17905,18945,29
20200329,ND,98,3355,3453,29
20200329,NE,108,1968,2076,29
20200329,NH,214,4524,4738,29
20200329,NJ,13386,22216,35602,29
20200329,NM,237,10769,11006,29
20200329,NV,738,8412,9150,29
20200329,NY,59513,112847,172360,29
20200329,OH,1653,19012,20665,29
20200329,OK,429,1205,1634,29
20200329,OR,548,10878,11426,29
20200329,PA,3394,30061,33455,29
20200329,PR,127,841,968,29
20200329,RI,294,2840,3134,29
20200329,SC,774,3015,3789,29
20200329,SD,90,3127,3217,29
20200329,TN,1537,19037,20574,29
20200329,TX,2552,23208,25760,29
20200329,UT,719,13274,13993,29
20200329,VA,890,9719,10609,29
20200329,VI,23,123,146,29
20200329,VT,235,3466,3701,29
20200329,WA,5121,69788,74909,29
20200329,WI,1112,16550,17662,29
20200329,WV,113,2705,2818,29
20200329,WY,86,1554,1640,29
20200328,AK,85,2836,2921,28
20200328,AL,696,4184,4880,28
20200328,AR,404,2938,3342,28
20200328,AS,,,0,28
20200328,AZ,873,7455,8328,28
20200328,CA,4643,20549,25192,28
20200328,CO,1734,9942,11676,28
20200328,CT,1291,7109,8400,28
20200328,DC,304,2211,2515,28
20200328,DE,214,36,250,28
20200328,FL,3763,35366,39129,28
20200328,GA,2366,8685,11051,28
20200328,GU,55,299,354,28
20200328,HI,120,4357,4477,28
20200328,IA,298,4375,4673,28
20200328,ID,230,3342,3572,28
20200328,IL,3491,22000,25491,28
20200328,IN,1232,7175,8407,28
20200328,KS,261,3671,3932,28
20200328,KY,302,4821,5123,28
20200328,LA,3315,21846,25161,28
20200328,MA,4158,30915,35073,28
20200328,MD,992,11516,12508,28
20200328,ME,211,3394,3605,28
20200328,MI,9287,14183,23470,28
20200328,MN,441,15688,16129,28
20200328,MO,838,10082,10920,28
20200328,MP,2,,2,28
20200328,MS,663,2560,3223,28
20200328,MT,129,3256,3385,28
20200328,NC,935,16592,17527,28
20200328,ND,83,2809,2892,28
20200328,NE,96,1904,2000,28
20200328,NH,187,3656,3843,28
20200328,NJ,11124,19386,30510,28
20200328,NM,191,9196,9387,28
20200328,NV,621,7901,8522,28
20200328,NY,52318,103616,155934,28
20200328,OH,1406,19012,20418,28
20200328,OK,377,1180,1557,28
20200328,OR,479,9693,10172,28
20200328,PA,2751,25254,28005,28
20200328,PR,100,739,839,28
20200328,RI,239,2541,2780,28
20200328,SC,539,2408,2947,28
20200328,SD,68,2592,2660,28
20200328,TN,1373,16965,18338,28
20200328,TX,2052,23208,25260,28
20200328,UT,602,10710,11312,28
20200328,VA,739,8427,9166,28
20200328,VI,22,106,128,28
20200328,VT,211,2163,2374,28
20200328,WA,4737,68202,72939,28
20200328,WI,989,15232,16221,28
20200328,WV,96,2331,2427,28
20200328,WY,82,1475,1557,28
20200327,AK,69,2319,2388,27
20200327,AL,587,4184,4771,27
20200327,AR,381,1545,1926,27
20200327,AS,,,0,27
20200327,AZ,736,7455,8191,27
20200327,CA,3879,17380,21259,27
20200327,CO,1430,8692,10122,27
20200327,CT,1291,7109,8400,27
20200327,DC,267,1897,2164,27
20200327,DE,163,36,199,27
20200327,FL,2765,28186,30951,27
20200327,GA,2001,7864,9865,27
20200327,GU,51,299,350,27
20200327,HI,106,4357,4463,27
20200327,IA,235,3740,3975,27
20200327,ID,189,2668,2857,27
20200327,IL,3026,18516,21542,27
20200327,IN,981,5955,6936,27
20200327,KS,202,3229,3431,27
20200327,KY,248,3768,4016,27
20200327,LA,2746,18613,21359,27
20200327,MA,3151,26244,29395,27
20200327,MD,774,94,868,27
20200327,ME,168,3394,3562,27
20200327,MI,8659,12639,21298,27
20200327,MN,398,13605,14003,27
20200327,MO,669,369,1038,27
20200327,MP,0,,0,27
20200327,MS,579,2560,3139,27
20200327,MT,108,2590,2698,27
20200327,NC,763,14373,15136,27
20200327,ND,65,2427,2492,27
20200327,NE,85,1761,1846,27
20200327,NH,158,3395,3553,27
20200327,NJ,8825,16547,25372,27
20200327,NM,136,8377,8513,27
20200327,NV,535,6161,6696,27
20200327,NY,44635,101118,145753,27
20200327,OH,1137,19012,20149,27
20200327,OK,322,1084,1406,27
20200327,OR,414,8510,8924,27
20200327,PA,2218,21016,23234,27
20200327,PR,79,519,598,27
20200327,RI,203,2306,2509,27
20200327,SC,456,2307,2763,27
20200327,SD,58,2387,2445,27
20200327,TN,1203,14888,16091,27
20200327,TX,1731,21935,23666,27
20200327,UT,480,8764,9244,27
20200327,VA,604,6733,7337,27
20200327,VI,19,55,74,27
20200327,VT,184,2077,2261,27
20200327,WA,4305,65887,70192,27
20200327,WI,842,13140,13982,27
20200327,WV,76,1779,1855,27
20200327,WY,70,1211,1281,27
20200326,AK,59,1801,1860,26
20200326,AL,506,3593,4099,26
20200326,AR,335,1504,1839,26
20200326,AS,,,0,26
20200326,AZ,577,347,924,26
20200326,CA,3006,17380,20386,26
20200326,CO,1086,6978,8064,26
20200326,CT,1012,5625,6637,26
20200326,DC,231,1626,1857,26
20200326,DE,130,36,166,26
20200326,FL,2355,23741,26096,26
20200326,GA,1525,7401,8926,26
20200326,GU,45,263,308,26
20200326,HI,95,4357,4452,26
20200326,IA,179,2578,2757,26
20200326,ID,123,2065,2188,26
20200326,IL,2538,14093,16631,26
20200326,IN,645,4006,4651,26
20200326,KS,168,2869,3037,26
20200326,KY,198,3102,3300,26
20200326,LA,2305,15724,18029,26
20200326,MA,2318,21327,23645,26
20200326,MD,580,94,674,26
20200326,ME,155,3394,3549,26
20200326,MI,7767,10305,18072,26
20200326,MN,346,12604,12950,26
20200326,MO,502,369,871,26
20200326,MP,0,,0,26
20200326,MS,485,2291,2776,26
20200326,MT,71,2128,2199,26
20200326,NC,636,12274,12910,26
20200326,ND,52,2039,2091,26
20200326,NE,73,1584,1657,26
20200326,NH,137,3001,3138,26
20200326,NJ,6876,13661,20537,26
20200326,NM,112,7681,7793,26
20200326,NV,420,4697,5117,26
20200326,NY,37258,84846,122104,26
20200326,OH,867,16449,17316,26
20200326,OK,248,958,1206,26
20200326,OR,327,6953,7280,26
20200326,PA,1687,16441,18128,26
20200326,PR,64,377,441,26
20200326,RI,165,1262,1427,26
20200326,SC,456,2307,2763,26
20200326,SD,46,1973,2019,26
20200326,TN,957,13952,14909,26
20200326,TX,1396,20028,21424,26
20200326,UT,402,7308,7710,26
20200326,VA,460,5729,6189,26
20200326,VI,17,55,72,26
20200326,VT,158,1850,2008,26
20200326,WA,3822,61987,65809,26
20200326,WI,707,11583,12290,26
20200326,WV,51,1031,1082,26
20200326,WY,53,1052,1105,26
20200325,AK,42,1649,1691,25
20200325,AL,283,2529,2812,25
20200325,AR,280,1437,1717,25
20200325,AS,,,0,25
20200325,AZ,450,323,773,25
20200325,CA,2355,15921,18276,25
20200325,CO,912,6789,7701,25
20200325,CT,875,5023,5898,25
20200325,DC,183,1423,1606,25
20200325,DE,115,36,151,25
20200325,FL,1682,15374,17056,25
20200325,GA,1247,4932,6179,25
20200325,GU,37,233,270,25
20200325,HI,90,4357,4447,25
20200325,IA,145,2578,2723,25
20200325,ID,73,1887,1960,25
20200325,IL,1865,12344,14209,25
20200325,IN,477,2879,3356,25
20200325,KS,126,2360,2486,25
20200325,KY,157,2865,3022,25
20200325,LA,1795,9656,11451,25
20200325,MA,1739,18079,19818,25
20200325,MD,423,94,517,25
20200325,ME,149,3177,3326,25
20200325,MI,7060,7537,14597,25
20200325,MN,287,11188,11475,25
20200325,MO,356,369,725,25
20200325,MP,0,,0,25
20200325,MS,377,1566,1943,25
20200325,MT,53,1948,2001,25
20200325,NC,504,9985,10489,25
20200325,ND,39,1734,1773,25
20200325,NE,61,1304,1365,25
20200325,NH,108,2356,2464,25
20200325,NJ,4402,10452,14854,25
20200325,NM,100,6742,6842,25
20200325,NV,321,4251,4572,25
20200325,NY,30811,72668,103479,25
20200325,OH,704,14060,14764,25
20200325,OK,164,805,969,25
20200325,OR,209,4350,4559,25
20200325,PA,1127,11193,12320,25
20200325,PR,51,317,368,25
20200325,RI,132,1262,1394,25
20200325,SC,424,2303,2727,25
20200325,SD,41,819,860,25
20200325,TN,784,11012,11796,25
20200325,TX,974,12520,13494,25
20200325,UT,346,6491,6837,25
20200325,VA,391,4979,5370,25
20200325,VI,17,55,72,25
20200325,VT,123,1589,1712,25
20200325,WA,3339,57929,61268,25
20200325,WI,585,10089,10674,25
20200325,WV,39,759,798,25
20200325,WY,44,954,998,25
20200324,AK,36,986,1022,24
20200324,AL,215,2106,2321,24
20200324,AR,218,947,1165,24
20200324,AS,,,0,24
20200324,AZ,357,313,670,24
20200324,CA,2102,13452,15554,24
20200324,CO,720,5504,6224,24
20200324,CT,618,4682,5300,24
20200324,DC,137,1195,1332,24
20200324,DE,91,36,127,24
20200324,FL,1412,13127,14539,24
20200324,GA,1026,4458,5484,24
20200324,GU,32,201,233,24
20200324,HI,77,3589,3666,24
20200324,IA,124,2315,2439,24
20200324,ID,50,1887,1937,24
20200324,IL,1535,9934,11469,24
20200324,IN,365,2566,2931,24
20200324,KS,98,2086,2184,24
20200324,KY,124,1762,1886,24
20200324,LA,1388,7215,8603,24
20200324,MA,1060,12714,13774,24
20200324,MD,349,94,443,24
20200324,ME,125,3014,3139,24
20200324,MI,6441,5796,12237,24
20200324,MN,262,5550,5812,24
20200324,MO,183,369,552,24
20200324,MP,0,,0,24
20200324,MS,320,1552,1872,24
20200324,MT,46,1643,1689,24
20200324,NC,398,8141,8539,24
20200324,ND,34,1454,1488,24
20200324,NE,52,975,1027,24
20200324,NH,101,1447,1548,24
20200324,NJ,3675,8325,12000,24
20200324,NM,83,5890,5973,24
20200324,NV,278,3954,4232,24
20200324,NY,25665,65605,91270,24
20200324,OH,564,140,704,24
20200324,OK,106,735,841,24
20200324,OR,209,4350,4559,24
20200324,PA,851,8643,9494,24
20200324,PR,39,268,307,24
20200324,RI,124,1200,1324,24
20200324,SC,298,2012,2310,24
20200324,SD,30,790,820,24
20200324,TN,667,10517,11184,24
20200324,TX,410,10757,11167,24
20200324,UT,299,5524,5823,24
20200324,VA,290,4180,4470,24
20200324,VI,17,,17,24
20200324,VT,95,1440,1535,24
20200324,WA,2877,53341,56218,24
20200324,WI,457,8237,8694,24
20200324,WV,20,610,630,24
20200324,WY,29,710,739,24
20200323,AK,22,946,968,23
20200323,AL,167,1665,1832,23
20200323,AR,174,906,1080,23
20200323,AS,,,0,23
20200323,AZ,265,309,574,23
20200323,CA,1733,12567,14300,23
20200323,CO,591,4845,5436,23
20200323,CT,415,4085,4500,23
20200323,DC,116,1113,1229,23
20200323,DE,68,36,104,23
20200323,FL,1171,11063,12234,23
20200323,GA,772,4297,5069,23
20200323,GU,29,161,190,23
20200323,HI,56,2955,3011,23
20200323,IA,105,2043,2148,23
20200323,ID,47,1309,1356,23
20200323,IL,1273,8583,9856,23
20200323,IN,259,1701,1960,23
20200323,KS,82,417,499,23
20200323,KY,104,1762,1866,23
20200323,LA,1172,4776,5948,23
20200323,MA,678,8263,8941,23
20200323,MD,288,94,382,23
20200323,ME,107,2791,2898,23
20200323,MI,5789,4697,10486,23
20200323,MN,235,4511,4746,23
20200323,MO,183,369,552,23
20200323,MP,0,,0,23
20200323,MS,249,1143,1392,23
20200323,MT,34,1146,1180,23
20200323,NC,297,8141,8438,23
20200323,ND,30,1353,1383,23
20200323,NE,50,356,406,23
20200323,NH,78,1374,1452,23
20200323,NJ,2844,359,3203,23
20200323,NM,65,5321,5386,23
20200323,NV,245,3490,3735,23
20200323,NY,20875,57414,78289,23
20200323,OH,442,140,582,23
20200323,OK,81,694,775,23
20200323,OR,191,3649,3840,23
20200323,PA,644,6595,7239,23
20200323,PR,31,189,220,23
20200323,RI,106,1143,1249,23
20200323,SC,298,1466,1764,23
20200323,SD,28,762,790,23
20200323,TN,615,3272,3887,23
20200323,TX,352,9703,10055,23
20200323,UT,257,4790,5047,23
20200323,VA,254,3443,3697,23
20200323,VI,17,,17,23
20200323,VT,75,1106,1181,23
20200323,WA,2496,48492,50988,23
20200323,WI,416,7050,7466,23
20200323,WV,16,444,460,23
20200323,WY,26,592,618,23
20200322,AK,22,946,968,22
20200322,AL,138,1464,1602,22
20200322,AR,165,711,876,22
20200322,AS,,,0,22
20200322,AZ,152,282,434,22
20200322,CA,1536,11304,12840,22
20200322,CO,475,4075,4550,22
20200322,CT,223,2877,3100,22
20200322,DC,98,957,1055,22
20200322,DE,56,36,92,22
20200322,FL,830,7990,8820,22
20200322,GA,600,3420,4020,22
20200322,GU,27,126,153,22
20200322,HI,48,263,311,22
20200322,IA,90,1215,1305,22
20200322,ID,42,1175,1217,22
20200322,IL,1049,7271,8320,22
20200322,IN,201,1293,1494,22
20200322,KS,64,417,481,22
20200322,KY,99,1472,1571,22
20200322,LA,837,2661,3498,22
20200322,MA,547,5476,6023,22
20200322,MD,244,94,338,22
20200322,ME,89,2264,2353,22
20200322,MI,5098,3712,8810,22
20200322,MN,169,4511,4680,22
20200322,MO,90,369,459,22
20200322,MP,0,,0,22
20200322,MS,207,1114,1321,22
20200322,MT,31,1146,1177,22
20200322,NC,255,6183,6438,22
20200322,ND,28,1260,1288,22
20200322,NE,48,356,404,22
20200322,NH,65,1188,1253,22
20200322,NJ,1914,327,2241,22
20200322,NM,57,4722,4779,22
20200322,NV,190,2448,2638,22
20200322,NY,15168,46233,61401,22
20200322,OH,351,140,491,22
20200322,OK,67,669,736,22
20200322,OR,161,2864,3025,22
20200322,PA,479,4964,5443,22
20200322,PR,23,183,206,22
20200322,RI,83,932,1015,22
20200322,SC,195,1466,1661,22
20200322,SD,21,740,761,22
20200322,TN,505,3272,3777,22
20200322,TX,334,8422,8756,22
20200322,UT,181,3508,3689,22
20200322,VA,219,3118,3337,22
20200322,VI,6,,6,22
20200322,VT,52,1106,1158,22
20200322,WA,2284,43640,45924,22
20200322,WI,385,6230,6615,22
20200322,WV,12,385,397,22
20200322,WY,24,438,462,22
20200321,AK,14,758,772,21
20200321,AL,124,28,152,21
20200321,AR,118,567,685,21
20200321,AS,,,0,21
20200321,AZ,104,240,344,21
20200321,CA,1279,11249,12528,21
20200321,CO,363,3317,3680,21
20200321,CT,194,2106,2300,21
20200321,DC,77,506,583,21
20200321,DE,45,36,81,21
20200321,FL,658,6579,7237,21
20200321,GA,507,2557,3064,21
20200321,GU,15,108,123,21
20200321,HI,37,124,161,21
20200321,IA,68,1049,1117,21
20200321,ID,31,880,911,21
20200321,IL,753,5488,6241,21
20200321,IN,126,707,833,21
20200321,KS,55,417,472,21
20200321,KY,54,714,768,21
20200321,LA,580,2180,2760,21
20200321,MA,426,4799,5225,21
20200321,MD,190,94,284,21
20200321,ME,73,2264,2337,21
20200321,MI,4543,3696,8239,21
20200321,MN,138,3952,4090,21
20200321,MO,73,369,442,21
20200321,MP,0,,0,21
20200321,MS,140,695,835,21
20200321,MT,20,1146,1166,21
20200321,NC,184,5092,5276,21
20200321,ND,28,1141,1169,21
20200321,NE,38,356,394,21
20200321,NH,55,973,1028,21
20200321,NJ,1327,294,1621,21
20200321,NM,57,3771,3828,21
20200321,NV,124,2384,2508,21
20200321,NY,10356,35081,45437,21
20200321,OH,247,140,387,21
20200321,OK,53,560,613,21
20200321,OR,114,2003,2117,21
20200321,PA,371,3766,4137,21
20200321,PR,21,143,164,21
20200321,RI,66,862,928,21
20200321,SC,152,1255,1407,21
20200321,SD,14,691,705,21
20200321,TN,371,3272,3643,21
20200321,TX,304,6218,6522,21
20200321,UT,136,2424,2560,21
20200321,VA,152,2638,2790,21
20200321,VI,6,,6,21
20200321,VT,29,779,808,21
20200321,WA,2042,41936,43978,21
20200321,WI,281,4628,4909,21
20200321,WV,11,330,341,21
20200321,WY,23,438,461,21
20200320,AK,12,686,698,20
20200320,AL,81,28,109,20
20200320,AR,96,351,447,20
20200320,AS,,,0,20
20200320,AZ,65,211,276,20
20200320,CA,1063,10424,11487,20
20200320,CO,277,2675,2952,20
20200320,CT,194,604,798,20
20200320,DC,71,501,572,20
20200320,DE,38,36,74,20
20200320,FL,520,1870,2390,20
20200320,GA,420,1966,2386,20
20200320,GU,14,86,100,20
20200320,HI,26,124,150,20
20200320,IA,45,642,687,20
20200320,ID,23,590,613,20
20200320,IL,585,3696,4281,20
20200320,IN,79,475,554,20
20200320,KS,44,417,461,20
20200320,KY,47,592,639,20
20200320,LA,473,568,1041,20
20200320,MA,314,3795,4109,20
20200320,MD,149,94,243,20
20200320,ME,57,2264,2321,20
20200320,MI,4027,2746,6773,20
20200320,MN,115,3741,3856,20
20200320,MO,47,369,416,20
20200320,MP,0,,0,20
20200320,MS,80,695,775,20
20200320,MT,16,931,947,20
20200320,NC,137,3096,3233,20
20200320,ND,20,800,820,20
20200320,NE,32,240,272,20
20200320,NH,44,745,789,20
20200320,NJ,890,264,1154,20
20200320,NM,43,3771,3814,20
20200320,NV,109,1992,2101,20
20200320,NY,7102,25325,32427,20
20200320,OH,169,140,309,20
20200320,OK,49,538,587,20
20200320,OR,114,2003,2117,20
20200320,PA,268,2574,2842,20
20200320,PR,14,114,128,20
20200320,RI,54,800,854,20
20200320,SC,81,833,914,20
20200320,SD,14,663,677,20
20200320,TN,228,563,791,20
20200320,TX,194,5083,5277,20
20200320,UT,112,2035,2147,20
20200320,VA,114,2211,2325,20
20200320,VI,3,,3,20
20200320,VT,29,779,808,20
20200320,WA,1804,39828,41632,20
20200320,WI,206,3455,3661,20
20200320,WV,7,219,226,20
20200320,WY,19,331,350,20
20200319,AK,6,432,438,19
20200319,AL,68,28,96,19
20200319,AR,46,310,356,19
20200319,AS,,,0,19
20200319,AZ,44,175,219,19
20200319,CA,924,8787,9711,19
20200319,CO,216,2112,2328,19
20200319,CT,96,604,700,19
20200319,DC,39,153,192,19
20200319,DE,30,36,66,19
20200319,FL,390,1533,1923,19
20200319,GA,287,1544,1831,19
20200319,GU,12,69,81,19
20200319,HI,16,93,109,19
20200319,IA,38,83,121,19
20200319,ID,11,459,470,19
20200319,IL,422,2725,3147,19
20200319,IN,56,324,380,19
20200319,KS,34,417,451,19
20200319,KY,35,454,489,19
20200319,LA,347,458,805,19
20200319,MA,229,2918,3147,19
20200319,MD,107,94,201,19
20200319,ME,53,2004,2057,19
20200319,MI,3392,1785,5177,19
20200319,MN,89,2949,3038,19
20200319,MO,24,308,332,19
20200319,MP,0,,0,19
20200319,MS,50,552,602,19
20200319,MT,12,761,773,19
20200319,NC,97,2408,2505,19
20200319,ND,15,493,508,19
20200319,NE,27,240,267,19
20200319,NH,39,621,660,19
20200319,NJ,742,210,952,19
20200319,NM,35,2762,2797,19
20200319,NV,95,1626,1721,19
20200319,NY,4152,18132,22284,19
20200319,OH,119,140,259,19
20200319,OK,44,466,510,19
20200319,OR,88,1329,1417,19
20200319,PA,185,1608,1793,19
20200319,PR,5,56,61,19
20200319,RI,44,654,698,19
20200319,SC,60,583,643,19
20200319,SD,11,551,562,19
20200319,TN,154,349,503,19
20200319,TX,143,2212,2355,19
20200319,UT,78,1448,1526,19
20200319,VA,94,1829,1923,19
20200319,VI,3,,3,19
20200319,VT,22,645,667,19
20200319,WA,1563,36060,37623,19
20200319,WI,155,2192,2347,19
20200319,WV,2,143,145,19
20200319,WY,18,271,289,19
20200318,AK,6,406,412,18
20200318,AL,46,28,74,18
20200318,AR,33,236,269,18
20200318,AS,,,0,18
20200318,AZ,28,148,176,18
20200318,CA,611,7981,8592,18
20200318,CO,183,1617,1800,18
20200318,CT,68,125,193,18
20200318,DC,31,138,169,18
20200318,DE,25,36,61,18
20200318,FL,314,1225,1539,18
20200318,GA,197,1311,1508,18
20200318,GU,8,57,65,18
20200318,HI,14,93,107,18
20200318,IA,29,83,112,18
20200318,ID,9,459,468,18
20200318,IL,288,1763,2051,18
20200318,IN,39,154,193,18
20200318,KS,16,417,433,18
20200318,KY,26,354,380,18
20200318,LA,240,335,575,18
20200318,MA,156,2115,2271,18
20200318,MD,85,94,179,18
20200318,ME,43,1670,1713,18
20200318,MI,2913,1215,4128,18
20200318,MN,77,2685,2762,18
20200318,MO,13,253,266,18
20200318,MP,0,,0,18
20200318,MS,34,479,513,18
20200318,MT,10,499,509,18
20200318,NC,63,1787,1850,18
20200318,ND,6,268,274,18
20200318,NE,24,206,230,18
20200318,NH,26,513,539,18
20200318,NJ,427,190,617,18
20200318,NM,28,2326,2354,18
20200318,NV,55,168,223,18
20200318,NY,2382,12215,14597,18
20200318,OH,88,140,228,18
20200318,OK,29,378,407,18
20200318,OR,75,1118,1193,18
20200318,PA,133,1187,1320,18
20200318,PR,5,31,36,18
20200318,RI,33,540,573,18
20200318,SC,60,583,643,18
20200318,SD,11,551,562,18
20200318,TN,98,349,447,18
20200318,TX,83,1824,1907,18
20200318,UT,63,131,194,18
20200318,VA,77,1201,1278,18
20200318,VI,2,,2,18
20200318,VT,19,592,611,18
20200318,WA,1414,31842,33256,18
20200318,WI,106,1577,1683,18
20200318,WV,1,122,123,18
20200318,WY,15,178,193,18
20200317,AK,3,334,337,17
20200317,AL,36,28,64,17
20200317,AR,22,197,219,17
20200317,AS,,,0,17
20200317,AZ,20,142,162,17
20200317,CA,483,7981,8464,17
20200317,CO,160,1056,1216,17
20200317,CT,41,125,166,17
20200317,DC,22,104,126,17
20200317,DE,16,36,52,17
20200317,FL,186,940,1126,17
20200317,GA,146,,146,17
20200317,GU,5,41,46,17
20200317,HI,10,,10,17
20200317,IA,23,83,106,17
20200317,ID,7,346,353,17
20200317,IL,159,1340,1499,17
20200317,IN,30,129,159,17
20200317,KS,15,382,397,17
20200317,KY,22,295,317,17
20200317,LA,137,286,423,17
20200317,MA,118,1633,1751,17
20200317,MD,57,94,151,17
20200317,ME,32,1303,1335,17
20200317,MI,2393,626,3019,17
20200317,MN,60,2276,2336,17
20200317,MO,8,207,215,17
20200317,MP,0,,0,17
20200317,MS,21,368,389,17
20200317,MT,8,303,311,17
20200317,NC,40,474,514,17
20200317,ND,3,220,223,17
20200317,NE,21,206,227,17
20200317,NH,17,355,372,17
20200317,NJ,267,163,430,17
20200317,NM,23,1249,1272,17
20200317,NV,55,168,223,17
20200317,NY,1700,5506,7206,17
20200317,OH,67,140,207,17
20200317,OK,17,247,264,17
20200317,OR,47,689,736,17
20200317,PA,96,879,975,17
20200317,PR,5,13,18,17
20200317,RI,23,403,426,17
20200317,SC,33,311,344,17
20200317,SD,11,551,562,17
20200317,TN,73,330,403,17
20200317,TX,64,1204,1268,17
20200317,UT,51,131,182,17
20200317,VA,67,961,1028,17
20200317,VI,2,,2,17
20200317,VT,10,495,505,17
20200317,WA,1240,27368,28608,17
20200317,WI,72,1038,1110,17
20200317,WV,0,80,80,17
20200317,WY,10,95,105,17
20200316,AK,1,143,144,16
20200316,AL,28,28,56,16
20200316,AR,22,132,154,16
20200316,AS,,,0,16
20200316,AZ,18,125,143,16
20200316,CA,335,7981,8316,16
20200316,CO,131,627,758,16
20200316,CT,26,125,151,16
20200316,DC,17,96,113,16
20200316,DE,8,36,44,16
20200316,FL,141,684,825,16
20200316,GA,121,,121,16
20200316,GU,3,23,26,16
20200316,HI,7,,7,16
20200316,IA,22,83,105,16
20200316,ID,5,265,270,16
20200316,IL,93,932,1025,16
20200316,IN,24,115,139,16
20200316,KS,11,166,177,16
20200316,KY,21,234,255,16
20200316,LA,115,188,303,16
20200316,MA,97,1199,1296,16
20200316,MD,37,94,131,16
20200316,ME,17,764,781,16
20200316,MI,1933,272,2205,16
20200316,MN,54,1839,1893,16
20200316,MO,6,164,170,16
20200316,MP,0,,0,16
20200316,MS,12,277,289,16
20200316,MT,7,198,205,16
20200316,NC,33,296,329,16
20200316,ND,1,123,124,16
20200316,NE,18,170,188,16
20200316,NH,13,271,284,16
20200316,NJ,178,120,298,16
20200316,NM,17,566,583,16
20200316,NV,45,168,213,16
20200316,NY,950,4543,5493,16
20200316,OH,50,140,190,16
20200316,OK,10,174,184,16
20200316,OR,39,579,618,16
20200316,PA,76,670,746,16
20200316,PR,5,9,14,16
20200316,RI,21,308,329,16
20200316,SC,28,235,263,16
20200316,SD,10,494,504,16
20200316,TN,52,270,322,16
20200316,TX,57,,57,16
20200316,UT,39,131,170,16
20200316,VA,51,438,489,16
20200316,VI,1,,1,16
20200316,VT,8,421,429,16
20200316,WA,1067,22980,24047,16
20200316,WI,47,504,551,16
20200316,WV,0,80,80,16
20200316,WY,3,,3,16
20200315,AK,1,143,144,15
20200315,AL,12,28,40,15
20200315,AR,16,103,119,15
20200315,AZ,12,121,133,15
20200315,CA,293,916,1209,15
20200315,CO,131,627,758,15
20200315,CT,20,125,145,15
20200315,DC,16,79,95,15
20200315,DE,6,36,42,15
20200315,FL,116,678,794,15
20200315,GA,99,,99,15
20200315,HI,2,,2,15
20200315,IA,18,83,101,15
20200315,ID,5,174,179,15
20200315,IL,64,449,513,15
20200315,IN,19,102,121,15
20200315,KS,8,135,143,15
20200315,KY,16,139,155,15
20200315,LA,90,156,246,15
20200315,MA,64,584,648,15
20200315,MD,31,94,125,15
20200315,ME,3,91,94,15
20200315,MI,1480,205,1685,15
20200315,MN,35,1387,1422,15
20200315,MO,5,122,127,15
20200315,MS,10,84,94,15
20200315,MT,7,103,110,15
20200315,NC,32,227,259,15
20200315,ND,1,95,96,15
20200315,NE,17,80,97,15
20200315,NH,13,271,284,15
20200315,NJ,98,120,218,15
20200315,NM,13,482,495,15
20200315,NV,21,168,189,15
20200315,NY,729,4543,5272,15
20200315,OH,36,139,175,15
20200315,OK,9,118,127,15
20200315,OR,36,420,456,15
20200315,PA,63,205,268,15
20200315,RI,20,271,291,15
20200315,SC,19,154,173,15
20200315,SD,9,327,336,15
20200315,TN,39,157,196,15
20200315,TX,56,,56,15
20200315,UT,28,131,159,15
20200315,VA,45,363,408,15
20200315,VT,4,348,352,15
20200315,WA,939,18372,19311,15
20200315,WI,33,313,346,15
20200315,WV,0,38,38,15
20200315,WY,3,,3,15
20200314,AK,1,143,144,14
20200314,AL,6,22,28,14
20200314,AR,12,65,77,14
20200314,AZ,12,121,133,14
20200314,CA,252,916,1168,14
20200314,CO,101,610,711,14
20200314,CT,11,125,136,14
20200314,DC,10,49,59,14
20200314,DE,6,36,42,14
20200314,FL,77,478,555,14
20200314,GA,66,,66,14
20200314,HI,2,,2,14
20200314,IA,17,83,100,14
20200314,ID,2,174,176,14
20200314,IL,46,316,362,14
20200314,IN,15,74,89,14
20200314,KS,6,93,99,14
20200314,KY,14,139,153,14
20200314,LA,51,109,160,14
20200314,MA,38,,38,14
20200314,MD,26,94,120,14
20200314,ME,3,91,94,14
20200314,MI,1196,205,1401,14
20200314,MN,21,847,868,14
20200314,MO,4,90,94,14
20200314,MS,6,84,90,14
20200314,MT,5,103,108,14
20200314,NC,23,137,160,14
20200314,ND,1,54,55,14
20200314,NE,14,80,94,14
20200314,NH,7,212,219,14
20200314,NJ,50,97,147,14
20200314,NM,10,237,247,14
20200314,NV,20,168,188,14
20200314,NY,524,2779,3303,14
20200314,OH,13,50,63,14
20200314,OK,4,36,40,14
20200314,OR,30,337,367,14
20200314,PA,47,205,252,14
20200314,RI,20,198,218,14
20200314,SC,13,110,123,14
20200314,SD,9,182,191,14
20200314,TN,32,130,162,14
20200314,TX,51,,51,14
20200314,UT,6,131,137,14
20200314,VA,30,117,147,14
20200314,VT,4,227,231,14
20200314,WA,806,16783,17589,14
20200314,WI,19,169,188,14
20200314,WV,0,26,26,14
20200314,WY,2,,2,14
20200313,AK,1,59,60,13
20200313,AL,1,11,12,13
20200313,AR,9,30,39,13
20200313,AZ,9,94,103,13
20200313,CA,202,916,1118,13
20200313,CO,72,524,596,13
20200313,CT,6,99,105,13
20200313,DC,10,20,30,13
20200313,DE,4,30,34,13
20200313,FL,50,478,528,13
20200313,GA,42,,42,13
20200313,HI,2,,2,13
20200313,IA,16,83,99,13
20200313,ID,0,131,131,13
20200313,IL,32,294,326,13
20200313,IN,12,61,73,13
20200313,KS,6,93,99,13
20200313,KY,11,107,118,13
20200313,LA,36,37,73,13
20200313,MA,23,,23,13
20200313,MD,17,94,111,13
20200313,ME,3,91,94,13
20200313,MI,945,133,1078,13
20200313,MN,14,541,555,13
20200313,MO,2,71,73,13
20200313,MS,4,41,45,13
20200313,MT,1,55,56,13
20200313,NC,15,86,101,13
20200313,ND,1,39,40,13
20200313,NE,13,80,93,13
20200313,NH,6,94,100,13
20200313,NJ,50,97,147,13
20200313,NM,10,190,200,13
20200313,NV,11,168,179,13
20200313,NY,421,2779,3200,13
20200313,OH,13,50,63,13
20200313,OK,3,36,39,13
20200313,OR,30,337,367,13
20200313,PA,41,140,181,13
20200313,RI,14,142,156,13
20200313,SC,12,75,87,13
20200313,SD,9,73,82,13
20200313,TN,26,116,142,13
20200313,TX,39,,39,13
20200313,UT,6,131,137,13
20200313,VA,30,117,147,13
20200313,VT,2,142,144,13
20200313,WA,702,14598,15300,13
20200313,WI,19,169,188,13
20200313,WV,0,17,17,13
20200313,WY,1,,1,13
20200312,AK,0,46,46,12
20200312,AL,0,10,10,12
20200312,AR,6,24,30,12
20200312,AZ,9,82,91,12
20200312,CA,202,916,1118,12
20200312,CO,45,298,343,12
20200312,CT,6,89,95,12
20200312,DC,10,20,30,12
20200312,DE,4,23,27,12
20200312,FL,32,301,333,12
20200312,GA,31,,31,12
20200312,HI,2,,2,12
20200312,IA,14,67,81,12
20200312,ID,0,93,93,12
20200312,IL,25,266,291,12
20200312,IN,12,52,64,12
20200312,KS,4,41,45,12
20200312,KY,8,56,64,12
20200312,LA,14,37,51,12
20200312,MA,8,,8,12
20200312,MD,12,94,106,12
20200312,ME,1,65,66,12
20200312,MI,702,91,793,12
20200312,MN,9,307,316,12
20200312,MO,1,64,65,12
20200312,MS,1,41,42,12
20200312,MT,1,34,35,12
20200312,NC,12,60,72,12
20200312,ND,1,12,13,12
20200312,NE,10,80,90,12
20200312,NH,6,94,100,12
20200312,NJ,30,74,104,12
20200312,NM,5,155,160,12
20200312,NV,7,168,175,12
20200312,NY,216,92,308,12
20200312,OH,5,30,35,12
20200312,OK,3,36,39,12
20200312,OR,19,286,305,12
20200312,PA,22,116,138,12
20200312,RI,5,94,99,12
20200312,SC,10,48,58,12
20200312,SD,8,27,35,12
20200312,TN,18,79,97,12
20200312,TX,23,,23,12
20200312,UT,4,131,135,12
20200312,VA,17,117,134,12
20200312,VT,2,97,99,12
20200312,WA,551,10571,11122,12
20200312,WI,8,84,92,12
20200312,WV,0,7,7,12
20200312,WY,1,,1,12
20200311,AK,0,46,46,11
20200311,AL,0,10,10,11
20200311,AR,0,12,12,11
20200311,AZ,9,59,68,11
20200311,CA,157,916,1073,11
20200311,CO,28,251,279,11
20200311,CT,3,71,74,11
20200311,DC,5,20,25,11
20200311,DE,1,17,18,11
20200311,FL,28,301,329,11
20200311,GA,22,,22,11
20200311,HI,2,,2,11
20200311,IA,13,46,59,11
20200311,ID,0,67,67,11
20200311,IL,19,244,263,11
20200311,IN,10,33,43,11
20200311,KS,1,41,42,11
20200311,KY,8,46,54,11
20200311,LA,6,37,43,11
20200311,MD,9,94,103,11
20200311,ME,0,42,42,11
20200311,MI,497,57,554,11
20200311,MN,5,217,222,11
20200311,MO,1,,1,11
20200311,MS,0,20,20,11
20200311,MT,0,21,21,11
20200311,NC,7,,7,11
20200311,ND,0,7,7,11
20200311,NE,5,47,52,11
20200311,NH,4,38,42,11
20200311,NJ,24,57,81,11
20200311,NM,3,87,90,11
20200311,NV,5,168,173,11
20200311,NY,216,92,308,11
20200311,OH,4,21,25,11
20200311,OK,2,15,17,11
20200311,OR,19,286,305,11
20200311,PA,16,88,104,11
20200311,RI,5,94,99,11
20200311,SC,9,32,41,11
20200311,SD,5,13,18,11
20200311,TN,7,50,57,11
20200311,TX,21,,21,11
20200311,UT,2,,2,11
20200311,VA,9,60,69,11
20200311,VT,1,62,63,11
20200311,WA,481,6977,7458,11
20200311,WI,3,43,46,11
20200311,WV,0,3,3,11
20200311,WY,0,,0,11
20200310,AK,0,23,23,10
20200310,AL,0,0,0,10
20200310,AR,0,12,12,10
20200310,AZ,6,51,57,10
20200310,CA,133,690,823,10
20200310,CO,12,142,154,10
20200310,CT,2,54,56,10
20200310,DC,5,17,22,10
20200310,DE,0,17,17,10
20200310,FL,19,222,241,10
20200310,GA,17,,17,10
20200310,HI,2,,2,10
20200310,IA,8,32,40,10
20200310,ID,0,41,41,10
20200310,IL,19,244,263,10
20200310,IN,6,30,36,10
20200310,KS,1,17,18,10
20200310,KY,6,28,34,10
20200310,LA,1,11,12,10
20200310,MD,6,89,95,10
20200310,ME,0,20,20,10
20200310,MI,358,39,397,10
20200310,MN,3,132,135,10
20200310,MO,1,,1,10
20200310,MS,0,,0,10
20200310,MT,0,15,15,10
20200310,NC,7,,7,10
20200310,ND,0,6,6,10
20200310,NE,3,47,50,10
20200310,NH,4,38,42,10
20200310,NJ,15,44,59,10
20200310,NM,0,69,69,10
20200310,NV,1,14,15,10
20200310,NY,173,92,265,10
20200310,OH,3,14,17,10
20200310,OK,2,15,17,10
20200310,OR,15,213,228,10
20200310,PA,12,,12,10
20200310,RI,3,58,61,10
20200310,SC,7,24,31,10
20200310,SD,0,11,11,10
20200310,TN,7,,7,10
20200310,TX,13,,13,10
20200310,UT,2,,2,10
20200310,VA,8,53,61,10
20200310,VT,1,40,41,10
20200310,WA,397,4850,5247,10
20200310,WI,2,36,38,10
20200310,WV,0,2,2,10
20200310,WY,0,0,0,10
20200309,AK,0,23,23,9
20200309,AL,0,,0,9
20200309,AR,0,12,12,9
20200309,AZ,5,44,49,9
20200309,CA,114,690,804,9
20200309,CO,9,133,142,9
20200309,CT,1,46,47,9
20200309,DC,1,14,15,9
20200309,DE,0,15,15,9
20200309,FL,18,140,158,9
20200309,GA,12,,12,9
20200309,HI,2,,2,9
20200309,IA,3,26,29,9
20200309,ID,0,41,41,9
20200309,IL,7,191,198,9
20200309,IN,2,,2,9
20200309,KS,1,11,12,9
20200309,KY,4,17,21,9
20200309,LA,1,5,6,9
20200309,MD,5,73,78,9
20200309,ME,0,1,1,9
20200309,MI,254,36,290,9
20200309,MN,2,80,82,9
20200309,MO,1,,1,9
20200309,MS,0,,0,9
20200309,MT,0,11,11,9
20200309,NC,2,,2,9
20200309,ND,0,0,0,9
20200309,NE,3,36,39,9
20200309,NH,4,38,42,9
20200309,NJ,11,35,46,9
20200309,NM,0,57,57,9
20200309,NV,1,14,15,9
20200309,NY,142,92,234,9
20200309,OH,3,11,14,9
20200309,OK,1,8,9,9
20200309,OR,14,165,179,9
20200309,PA,10,,10,9
20200309,RI,3,30,33,9
20200309,SC,7,24,31,9
20200309,SD,0,5,5,9
20200309,TN,3,,3,9
20200309,TX,12,,12,9
20200309,UT,1,,1,9
20200309,VA,3,38,41,9
20200309,VT,1,34,35,9
20200309,WA,349,3173,3522,9
20200309,WI,1,36,37,9
20200309,WV,0,2,2,9
20200309,WY,0,,0,9
20200308,AK,0,14,14,8
20200308,AL,0,,0,8
20200308,AR,0,6,6,8
20200308,AZ,5,44,49,8
20200308,CA,88,462,550,8
20200308,CO,8,104,112,8
20200308,CT,1,29,30,8
20200308,DC,1,10,11,8
20200308,DE,0,10,10,8
20200308,FL,17,118,135,8
20200308,GA,7,,7,8
20200308,HI,1,,1,8
20200308,IA,0,15,15,8
20200308,ID,0,27,27,8
20200308,IL,6,191,197,8
20200308,IN,2,,2,8
20200308,KS,1,11,12,8
20200308,KY,1,13,14,8
20200308,LA,0,5,5,8
20200308,MD,3,52,55,8
20200308,ME,0,1,1,8
20200308,MI,168,26,194,8
20200308,MN,1,48,49,8
20200308,MO,1,,1,8
20200308,MS,0,,0,8
20200308,MT,0,11,11,8
20200308,NC,2,,2,8
20200308,ND,0,0,0,8
20200308,NE,1,17,18,8
20200308,NH,4,38,42,8
20200308,NJ,6,31,37,8
20200308,NM,0,48,48,8
20200308,NV,1,14,15,8
20200308,NY,105,92,197,8
20200308,OH,0,10,10,8
20200308,OK,1,8,9,8
20200308,OR,14,100,114,8
20200308,PA,6,,6,8
20200308,RI,3,30,33,8
20200308,SC,2,8,10,8
20200308,SD,0,5,5,8
20200308,TN,3,,3,8
20200308,TX,8,,8,8
20200308,UT,1,,1,8
20200308,VA,2,36,38,8
20200308,VT,1,28,29,8
20200308,WA,249,2208,2457,8
20200308,WI,1,31,32,8
20200308,WV,0,2,2,8
20200308,WY,0,,0,8
20200307,AK,0,12,12,7
20200307,AL,0,,0,7
20200307,AR,0,6,6,7
20200307,AZ,5,44,49,7
20200307,CA,69,462,531,7
20200307,CO,8,55,63,7
20200307,CT,0,,0,7
20200307,DC,0,8,8,7
20200307,DE,0,10,10,7
20200307,FL,14,100,114,7
20200307,GA,6,,6,7
20200307,HI,1,,1,7
20200307,IA,0,15,15,7
20200307,ID,0,27,27,7
20200307,IL,6,191,197,7
20200307,IN,1,,1,7
20200307,KS,0,11,11,7
20200307,KY,1,9,10,7
20200307,LA,0,,0,7
20200307,MD,3,41,44,7
20200307,ME,0,1,1,7
20200307,MI,128,18,146,7
20200307,MN,1,48,49,7
20200307,MO,0,,0,7
20200307,MS,0,,0,7
20200307,MT,0,11,11,7
20200307,NC,2,,2,7
20200307,ND,0,0,0,7
20200307,NE,1,17,18,7
20200307,NH,2,20,22,7
20200307,NJ,4,,4,7
20200307,NM,0,48,48,7
20200307,NV,1,14,15,7
20200307,NY,76,92,168,7
20200307,OH,0,9,9,7
20200307,OK,1,,1,7
20200307,OR,7,77,84,7
20200307,PA,4,,4,7
20200307,RI,2,30,32,7
20200307,SC,2,8,10,7
20200307,SD,0,5,5,7
20200307,TN,1,,1,7
20200307,TX,8,,8,7
20200307,UT,1,,1,7
20200307,VA,0,31,31,7
20200307,VT,0,16,16,7
20200307,WA,182,1746,1928,7
20200307,WI,1,31,32,7
20200307,WV,0,2,2,7
20200307,WY,0,,0,7
20200306,AK,0,8,8,6
20200306,AR,0,6,6,6
20200306,AZ,3,33,36,6
20200306,CA,60,462,522,6
20200306,CO,2,46,48,6
20200306,DC,0,8,8,6
20200306,DE,0,10,10,6
20200306,FL,9,55,64,6
20200306,GA,2,,2,6
20200306,IA,0,15,15,6
20200306,IL,5,180,185,6
20200306,IN,1,,1,6
20200306,KS,0,4,4,6
20200306,KY,0,7,7,6
20200306,MD,3,26,29,6
20200306,MI,98,8,106,6
20200306,MN,0,36,36,6
20200306,NC,2,,2,6
20200306,NE,0,17,17,6
20200306,NH,2,20,22,6
20200306,NJ,1,,1,6
20200306,NM,0,16,16,6
20200306,NV,1,14,15,6
20200306,NY,33,92,125,6
20200306,OH,0,8,8,6
20200306,OR,3,64,67,6
20200306,PA,2,,2,6
20200306,RI,3,17,20,6
20200306,SC,0,5,5,6
20200306,TN,1,,1,6
20200306,TX,5,,5,6
20200306,VA,0,21,21,6
20200306,VT,0,8,8,6
20200306,WA,150,1378,1528,6
20200306,WI,1,31,32,6
20200306,WV,0,1,1,6
20200305,AZ,2,28,30,5
20200305,CA,53,462,515,5
20200305,CO,0,19,19,5
20200305,DC,0,6,6,5
20200305,FL,9,31,40,5
20200305,GA,2,,2,5
20200305,IL,5,165,170,5
20200305,MD,0,17,17,5
20200305,MI,72,8,80,5
20200305,NC,1,,1,5
20200305,NE,0,17,17,5
20200305,NH,2,16,18,5
20200305,NJ,1,,1,5
20200305,NV,1,14,15,5
20200305,NY,22,76,98,5
20200305,OH,0,7,7,5
20200305,OR,3,45,48,5
20200305,RI,2,17,19,5
20200305,SC,0,5,5,5
20200305,TN,1,,1,5
20200305,TX,1,,1,5
20200305,VA,0,18,18,5
20200305,WA,97,943,1040,5
20200305,WI,1,19,20,5
20200304,AZ,2,27,29,4
20200304,CA,53,462,515,4
20200304,FL,2,24,26,4
20200304,GA,2,,2,4
20200304,IL,4,124,128,4
20200304,MI,52,,52,4
20200304,NC,1,,1,4
20200304,NH,2,10,12,4
20200304,NY,6,48,54,4
20200304,OR,3,29,32,4
20200304,RI,2,11,13,4
20200304,SC,0,5,5,4
20200304,TX,1,,1,4
20200304,WA,76,631,707,4
20200304,WI,1,19,20,4
20200303,MI,34,,34,3
20200303,RI,2,6,8,3
20200303,WA,58,427,485,3
20200302,MI,18,,18,2
20200302,RI,1,,1,2
20200302,WA,34,229,263,2
20200301,MI,9,,9,1
20200301,RI,1,,1,1
20200301,WA,30,81,111,1